-G#---
-##?##
--#---
#?##-#
#--?-#
###P##


P # # # # # # # # #
- - - # - - - Q - #
- # - - - # # # - #
- - - # - # # # - #
# # Q # - # # # - #
# - - - - # - - - #
# - # # # # - # - #
# - # - - Q - - - #
# - - - # - # - - #
# # # # # # # # D #

P # # # # # # # # #
- - - # - - - Q - #
- # - - - # # # - #
- - - # - # # # - #
# # Q # - # # # - #
# - - - - # - - - #
# - # # # # - # - #
# - # - - Q - - - #
# - - - # - # - - #
# # # # # # # # D #
